
Node.js and npm packages provide a wide range of options for working with various file types. Here are some common file types that can be extracted or manipulated using Node.js and npm packages:

Text Files:

TXT: Plain text files.
CSV: Comma-separated values files.
JSON: JavaScript Object Notation files.
Markdown: Markdown files.
XML: Extensible Markup Language files.
HTML: HyperText Markup Language files.
YAML: YAML Ain't Markup Language files.
Document Files:

PDF: Portable Document Format files.
DOCX: Microsoft Word Document files.
RTF: Rich Text Format files.
Spreadsheet Files:

XLSX: Microsoft Excel Spreadsheet files.
CSV: Comma-separated values files.
Image Files:

JPEG/JPG: Joint Photographic Experts Group image files.
PNG: Portable Network Graphics image files.
GIF: Graphics Interchange Format image files.
SVG: Scalable Vector Graphics image files.
BMP: Bitmap image files.
Audio Files:

MP3: MPEG Audio Layer III audio files.
WAV: Waveform Audio File Format audio files.
OGG: Ogg Vorbis audio files.
Video Files:

MP4: MPEG-4 video files.
AVI: Audio Video Interleave video files.
MKV: Matroska video files.
WEBM: WebM video files.
Archive Files:

ZIP: Zip archive files.
TAR: Tape archive files.
GZIP: Gzip compressed files.
RAR: RAR archive files.
Database Files:

SQL: SQL database files.
SQLite: SQLite database files.
Configuration Files:

INI: INI configuration files.
YAML: YAML configuration files.
JSON: JSON configuration files.
Font Files:

TTF: TrueType Font files.
OTF: OpenType Font files.
Binary Files:

BIN: Binary files.
EXE: Executable files.
DLL: Dynamic Link Library files.
Compressed Files:

GZ: Gzip compressed files.
BZ2: Bzip2 compressed files.
7z: 7-Zip archive files.
Log Files:

LOG: Log files in various formats.
Other Custom Formats:

Custom file formats or proprietary file types used in specific applications.